id,center_name,total_voter,1,2,3,4,5,6,7,8,9,10,11,total_legal_vote,total_cancelled_vote,total_vote,total_vote_rate
51,"ডহরপুকুরিয়া হাফেজিয়া মাদ্রাসা, (উভয়)",996,0,180,0,0,1,0,208,1,2,0,0,392,16,408,39.36
52,"নাদকুন্ডু সরকারি প্রাথমিক বিদ্যালয়, (উভয়)",1715,0,658,6,4,5,3,227,3,2,4,8,920,60,980,53.64
54,"গিলাপোল সরকারি প্রাথমিক বিদ্যালয়, (উভয়)",1597,0,384,2,0,1,1,306,1,4,0,2,701,27,728,43.89
157,"ভাতুড়িয়া মাধ্যমিক বিদ্যালয়, (উভয়)",3558,4,1903,9,5,0,5,310,3,9,6,0,2254,98,2352,63.35
165,"শড়াতলা সরকারি প্রাথমিক বিদ্যালয়, (উভয়)",1549,0,658,0,0,0,0,335,0,0,0,0,993,29,1022,64.11
179,"সাবেক বিন্নী সরকারি প্রাথমিক বিদ্যালয়, (উভয়)",2014,0,526,2,1,2,0,358,2,0,1,0,892,24,916,44.29
101,"অচিন্তানগর সরকারি প্রাথমিক বিদ্যালয়, (উভয়)",1366,0,581,2,2,1,3,370,3,0,0,1,963,17,980,70.50
77,"ছবেদ আলী মাধ্যমিক বিদ্যালয়, (উভয়)",2463,1,684,4,1,1,2,388,6,12,5,1,1105,83,1188,44.86
131,"দোবিলা সরকারি প্রাথমিক বিদ্যালয়, (উভয়)",2516,1,778,2,1,0,5,402,2,5,5,0,1201,12,1213,47.73
124,"চটকাবাড়ীয়া সরকারি প্রাথমিক বিদ্যালয়, (উভয়)",2190,2,759,2,0,1,0,427,1,8,0,0,1200,43,1243,54.79
149,"দখলপুর সরকারি প্রাথমিক বিদ্যালয়, (উভয়)",2121,0,375,3,1,1,7,427,0,8,5,1,828,53,881,39.04
151,"দৌলৎপুর সরকারি প্রাথমিক বিদ্যালয়, (উভয়)",1617,1,380,2,2,0,4,429,3,7,2,1,831,58,889,51.39
128,"মান্দারতলা-জোড়াপুকুরিয়া সরকারি প্রাথমিক বিদ্যালয়, (উভয়)",1843,0,535,3,1,0,2,432,3,8,2,1,987,58,1045,53.55
150,"কে,বি একাডেমী পারদখলপুর মাধ্যমিক বিদ্যালয়, (উভয়)",2086,4,375,2,1,0,4,436,3,6,3,0,834,39,873,39.98
76,"গান্না সরকারি প্রাথমিক বিদ্যালয়, (উভয়)",2463,1,473,0,0,1,1,447,2,6,2,1,934,53,987,37.92
115,"চুটলিয়া সরকারি প্রাথমিক বিদ্যালয়, (উভয়)",1086,0,228,0,0,0,1,451,2,2,1,0,685,20,705,63.08
49,"পশ্চিম দুর্গাপুর সরকারি প্রাথমিক বিদ্যালয়, (উভয়)",2322,3,585,1,1,1,5,486,2,11,3,0,1098,36,1134,47.29
118,"পূর্ব কৃষ্ণপুর সরকারি প্রাথমিক বিদ্যালয়, (উভয়)",1974,1,895,4,1,0,2,501,5,4,1,0,1414,21,1435,71.63
148,"ফতেপুর সরকারি প্রাথমিক বিদ্যালয়, (উভয়)",1753,0,470,2,0,2,3,507,0,5,1,2,992,36,1028,56.59
74,"রঘুনাথপুর সরকারি প্রাথমিক বিদ্যালয়, (উভয়)",2088,2,621,3,0,0,1,509,2,1,5,0,1144,51,1195,54.79
62,"রামচন্দ্রপুর স্কুল এন্ড কলেজ, (উভয়)",2456,0,427,1,3,2,1,514,4,2,4,1,959,54,1013,39.05
166,"বলরামপুর দারুস সুন্নাহ দাখিল মাদ্রাসা, (উভয়)",2034,0,640,0,2,0,2,514,3,2,2,1,1166,0,1166,57.33
156,"হিংগারপাড়া সরকারি প্রাথমিক বিদ্যালয়, (উভয়)",1841,0,436,1,1,1,5,516,1,5,3,0,969,48,1017,52.63
95,"বাকড়ী সরকারি প্রাথমিক বিদ্যালয়, (উভয়)",2524,1,1185,1,1,1,1,523,3,4,1,0,1721,29,1750,68.19
68,"ডেফলবাড়ী সরকারি প্রাথমিক বিদ্যালয়, (উভয়)",2000,0,739,1,2,0,1,528,2,3,1,0,1277,14,1291,63.85
183,"কন্যাদহ সরকারি প্রাথমিক বিদ্যালয়, (উভয়)",2531,3,843,0,2,0,2,532,6,1,2,0,1391,29,1420,54.96
14,"ঝিনাইদহ সরকারি উচ্চ বালিকা বিদ্যালয়, (উভয়)",2027,0,249,0,1,0,0,533,1,1,2,0,787,9,796,38.83
61,"গাড়ামারা সোনার দাইড় সরকারি প্রাথমিক বিদ্যালয়, (উভয়)",2559,0,555,1,0,1,4,535,1,4,1,1,1103,40,1143,43.10
168,"শিংগা আশরাফ উদ্দীন সরকারি প্রাথমিক বিদ্যালয়, (উভয়)",1799,3,384,3,2,1,7,537,3,8,4,6,958,51,1009,53.25
75,"রঘুনাথপুর মাধ্যমিক বিদ্যালয়, (উভয়)",2152,1,654,0,0,2,4,538,3,0,3,1,1206,40,1246,56.04
36,"মাগুরা পোতাহাটি সরকারি প্রাথমিক বিদ্যালয়, (উভয়)",1976,1,310,1,1,0,3,539,1,3,0,8,867,33,900,43.88
37,"আঃ রউফ ডিগ্রি কলেজ, (উভয়)",2670,0,444,1,3,0,0,539,2,1,0,21,1011,58,1069,37.87
11,"শিশুকুঞ্জ স্কুল অ্যান্ড কলেজ, (উভয়)",1757,3,350,0,0,0,1,557,1,0,3,0,915,17,932,52.08
7,"ঝিনাইদহ নিউ একাডেমী, (উভয়)",2063,0,181,0,0,0,0,558,0,1,0,0,740,8,748,35.87
65,"নগরবাথান সরকারি প্রাথমিক বিদ্যালয়, (উভয়)",2096,1,557,1,3,1,1,559,3,6,2,3,1137,50,1187,54.25
126,"হরিণাকুন্ডু প্রিয়নাথ স্কুল এন্ড কলেজ, (উভয়)",2133,0,533,1,1,0,3,559,0,12,3,0,1112,20,1132,52.13
127,"হরিণাকুন্ডু মডেল সরকারি প্রাথমিক বিদ্যালয়, (উভয়)",2187,0,440,0,0,1,1,562,1,1,3,0,1009,39,1048,46.14
79,"গিলাবাড়ীয়া সরকারি প্রাথমিক বিদ্যালয়, (উভয়)",1415,1,382,2,0,1,1,572,2,0,5,0,966,28,994,68.27
20,"আব্দুর রকিব মাধ্যমিক বালিকা বিদ্যালয়, (উভয়)",2572,2,292,0,0,0,0,573,1,3,4,0,875,10,885,34.02
136,"ভেড়াখালী সরকারি প্রাথমিক বিদ্যালয়, (উভয়)",2153,1,499,0,5,1,194,573,5,2,40,0,1320,45,1365,61.31
143,"শ্রীপুর সরকারি প্রাথমিক বিদ্যালয়, (উভয়)",1973,1,458,2,1,2,7,573,0,10,4,0,1058,43,1101,53.62
153,"সোনাতনপুর সরকারি প্রাথমিক বিদ্যালয়, (উভয়)",2168,4,504,0,0,0,2,575,4,1,3,0,1093,55,1148,50.42
82,"বানিয়াকান্দর সরকারি প্রাথমিক বিদ্যালয়, (উভয়)",1623,0,520,0,0,0,0,576,4,5,0,0,1105,20,1125,68.08
39,"গোবিন্দপুর সরকারি প্রাথমিক বিদ্যালয়, (উভয়)",2600,2,257,4,0,0,1,581,6,13,4,1,869,74,943,33.42
155,"গোবরাপাড়া সরকারি প্রাথমিক বিদ্যালয়, (উভয়)",2443,2,651,2,1,0,7,581,4,3,2,8,1261,48,1309,51.62
121,"শুড়া সরকারি প্রাথমিক বিদ্যালয়, (উভয়)",2321,1,697,1,3,0,5,584,3,6,6,1,1307,63,1370,56.31
43,"মামুনশিয়া সরকারি প্রাথমিক বিদ্যালয়, (উভয়)",1789,1,493,2,0,9,0,586,0,1,1,1,1094,29,1123,61.15
144,"ধুলিয়া আদর্শ মাধ্যমিক বিদ্যালয়, (উভয়)",1954,1,606,0,2,0,27,588,1,8,12,1,1246,26,1272,63.77
140,"ভবানীপুর মাধ্যমিক বিদ্যালয়, পুরাতন ভবন, (উভয়)",2536,2,563,3,4,1,15,602,5,5,6,1,1207,80,1287,47.59
33,"খান-এ খোদা সরকারি প্রাথমিক বিদ্যালয়, (উভয়)",2330,2,702,1,0,0,0,608,1,4,2,0,1320,11,1331,56.65
146,"তাহেরহুদা সরকারি প্রাথমিক বিদ্যালয়, (উভয়)",2924,4,1041,0,0,1,4,608,6,5,6,0,1675,38,1713,57.28
87,"রূপদাহ সরকারি প্রাথমিক বিদ্যালয়, (উভয়)",1568,2,457,2,1,0,0,619,1,3,2,0,1087,24,1111,69.32
67,"ধোপাবিলা সরকারি প্রাথমিক বিদ্যালয়, (উভয়)",3333,1,902,2,1,0,0,629,4,7,5,0,1551,35,1586,46.53
135,"ভায়না সরকারি প্রাথমিক বিদ্যালয়, পাকা ভবন, (উভয়)",2322,1,242,2,1,1,4,629,8,5,6,0,899,31,930,38.72
29,"শিকারপুর মাধ্যমিক বিদ্যালয়, (উভয়)",2256,1,380,2,0,0,0,634,2,5,0,0,1024,9,1033,45.39
10,"ঝিনাইদহ কলেজ, (উভয়)",2050,1,325,0,0,0,1,638,0,5,1,0,971,21,992,47.37
13,"ঝিনাইদহ সরকারি উচ্চ বালিকা বিদ্যালয়, (উভয়)",1970,0,296,0,0,0,0,640,1,3,4,1,945,5,950,47.97
147,"আন্দুলিয়া মাধ্যমিক বিদ্যালয়, (উভয়)",2407,0,435,2,1,0,8,641,5,12,7,0,1111,37,1148,46.16
38,"বংকিরা মাধ্যমিক বিদ্যালয়, (উভয়)",1755,1,423,2,1,1,0,647,2,2,2,0,1081,19,1100,61.60
164,"কুলবাড়ীয়া সরকারি প্রাথমিক বিদ্যালয়, (উভয়)",2658,1,1021,0,0,0,2,650,1,3,1,0,1679,39,1718,63.17
177,"দরিবিন্নী মাধ্যমিক বিদ্যালয়, দরিবিন্নী, (উভয়)",2367,1,701,0,1,0,1,651,0,1,2,0,1358,20,1378,57.37
19,"শহীদ মোশাররফ হোসেন সরকারি প্রাথমিক বিদ্যালয়, (উভয়)",2737,0,584,1,3,0,1,652,1,3,2,0,1247,33,1280,45.56
185,"দুর্লভপুর সরকারি প্রাথমিক বিদ্যালয়, (উভয়)",2634,1,902,4,3,2,0,653,3,2,1,0,1571,42,1613,59.64
63,"নেবুতলা সরকারি প্রাথমিক বিদ্যালয়, (উভয়)",2007,0,538,1,2,0,2,655,0,3,2,0,1203,36,1239,59.94
48,"কামতা সরকারি প্রাথমিক বিদ্যালয়, (উভয়)",2936,0,524,1,0,0,0,662,3,8,0,2,1200,54,1254,40.87
141,"ভবানীপুর মাধ্যমিক বিদ্যালয়, নতুন ভবন, (উভয়)",2481,2,493,2,0,0,7,662,3,9,9,2,1189,80,1269,47.92
64,"কনেজপুর সরকারি প্রাথমিক বিদ্যালয়, (উভয়)",2121,0,519,3,2,1,1,663,3,3,1,0,1196,32,1228,56.39
17,"সরকারি কেশব চন্দ্র কলেজ, (উভয়)",2066,0,256,1,0,0,1,665,0,1,0,0,924,8,932,44.72
163,"শাখারীদহ সরকারি প্রাথমিক বিদ্যালয়, (উভয়)",2869,2,912,1,2,0,0,667,2,2,3,0,1591,45,1636,55.45
180,"হামিরহাটি সরকারি প্রাথমিক বিদ্যালয়, (উভয়)",2487,2,673,1,3,0,1,667,1,3,4,0,1355,43,1398,54.48
46,"চাঁন্দুয়ালী সরকারি প্রাথমিক বিদ্যালয়, (উভয়)",2114,0,170,0,0,1,0,669,3,6,1,1,851,48,899,40.26
59,"হলিধানী মাধ্যমিক বিদ্যালয়, (উভয়)",3581,0,1113,2,0,1,1,672,4,4,5,1,1803,67,1870,50.35
27,"ঝিনাইদহ সাধুপতিরাম মাধ্যমিক বিদ্যালয়, (উভয়)",3071,1,724,0,1,0,0,674,1,11,0,2,1414,19,1433,46.04
172,"আড়ুয়াকান্দি সরকারি প্রাথমিক বিদ্যালয়, (উভয়)",1820,0,543,4,0,1,1,675,6,3,4,1,1238,43,1281,68.02
72,"কুঠিদুর্গাপুর সরকারি প্রাথমিক বিদ্যালয়, (উভয়)",2193,1,621,2,1,1,1,676,3,7,6,0,1319,31,1350,60.15
26,"ঝিনাইদহ সরকারি উচ্চ বিদ্যালয়, (উভয়)",3007,1,333,1,1,1,0,678,5,1,1,0,1022,20,1042,33.99
107,"দোগাছী সরকারি প্রাথমিক বিদ্যালয়, (উভয়)",2549,0,861,1,1,0,0,680,3,3,2,1,1552,33,1585,60.89
45,"মধুহাটি সরকারি প্রাথমিক বিদ্যালয়, (উভয়)",3168,1,616,4,2,2,2,683,7,4,2,0,1323,89,1412,41.76
8,"আরাপপুর মডেল সরকারি প্রাথমিক বিদ্যালয়, (উভয়)",2534,1,601,1,1,0,0,684,4,2,1,0,1295,25,1320,51.10
56,"সাগান্না সিদ্দিকীয়া দাখিল মাদ্রাসা, (উভয়)",2535,1,399,0,3,0,3,684,5,0,1,4,1100,37,1137,43.39
108,"কলামনখালী সরকারি প্রাথমিক বিদ্যালয়, (উভয়)",3630,1,1366,1,0,0,0,685,6,4,5,0,2068,23,2091,56.97
171,"ভবিতপুর সরকারি প্রাথমিক বিদ্যালয়, (উভয়)",1975,3,535,3,5,0,2,685,6,3,5,1,1248,54,1302,63.19
35,"সাধুহাটি সরকারি প্রাথমিক বিদ্যালয়, (উভয়)",2597,3,490,2,0,0,3,686,2,5,3,3,1197,53,1250,46.09
103,"রাইচরণ তারিণীচরণ ডিগ্রি কলেজ, (উভয়)",2616,0,1021,0,1,0,0,687,3,6,2,0,1720,40,1760,65.75
60,"কাতলামারী সরকারি প্রাথমিক বিদ্যালয়, (উভয়)",2807,3,680,0,1,1,7,689,6,2,1,2,1392,45,1437,49.59
30,"রিয়াদুল জান্নাত আদর্শ মাদ্রাসা, (উভয়)",2230,0,433,0,1,0,1,691,2,19,0,0,1147,23,1170,51.43
160,"শিতলী সরকারি প্রাথমিক বিদ্যালয়, (উভয়)",2368,1,599,0,0,1,0,696,1,5,3,0,1306,46,1352,55.15
21,"ফজর আলী গার্লস স্কুল এন্ড কলেজ, (উভয়)",2995,1,193,0,1,0,2,701,2,3,3,1,907,9,916,30.28
42,"চোরকোল সরকারি প্রাথমিক বিদ্যালয়, (উভয়)",3288,0,937,4,0,0,0,701,3,7,1,1,1654,37,1691,50.30
100,"মাওলানাবাদ সরকারি প্রাথমিক বিদ্যালয়, (উভয়)",2628,1,747,2,2,0,2,705,3,2,4,1,1469,65,1534,55.90
184,"মকিমপুর জসিম উদ্দিন সরকারি প্রাথমিক বিদ্যালয়, (উভয়)",2426,1,784,2,2,0,1,707,1,2,3,4,1507,54,1561,62.12
28,"ঝিনাইদহ সাধুপতিরাম মাধ্যমিক বিদ্যালয়, (উভয়)",3215,0,614,0,1,0,0,708,4,9,0,0,1336,14,1350,41.56
44,"বাজার গোপালপুর স্কুল এ্যান্ড কলেজ, (উভয়)",3889,1,951,6,0,3,4,710,4,9,5,0,1693,18,1711,43.53
170,"রঘুনাথপুর হোসেন আলী আলীম মাদ্রাসা, (উভয়)",2550,2,473,1,4,0,6,711,2,7,3,2,1211,43,1254,47.49
25,"ঝিনাইদহ সরকারি উচ্চ বিদ্যালয়, (উভয়)",2786,1,462,0,1,0,0,714,1,0,1,1,1181,37,1218,42.39
178,"দরিবিন্নী মাধ্যমিক বিদ্যালয়, দরিবিন্নী, (উভয়)",2459,0,737,2,0,1,0,714,4,5,2,0,1465,13,1478,59.58
110,"হুদা পুটিয়া সরকারি প্রাথমিক বিদ্যালয়, (উভয়)",2144,2,654,0,1,1,0,721,1,5,1,0,1386,25,1411,64.65
98,"সুতলিয়া শহীদ স্মৃতি সরকারি প্রাথমিক বিদ্যালয়, (উভয়)",3089,0,1397,0,3,0,4,722,2,4,1,1,2134,37,2171,69.08
23,"কালিকাপুর মুক্তিযোদ্ধা আঃ রশিদ সরকারি প্রাথমিক বিদ্যালয়, (উভয়)",2295,1,533,1,1,1,0,727,2,3,3,0,1272,6,1278,55.42
123,"পার্বতীপুর সরকারি প্রাথমিক বিদ্যালয়, (উভয়)",2115,0,448,0,1,0,3,727,1,3,3,0,1186,40,1226,56.08
133,"কালিশংকরপুর সরকারি প্রাথমিক বিদ্যালয়, (উভয়)",2185,3,534,7,2,2,8,732,2,9,7,0,1306,48,1354,59.77
2,"চাকলা কিন্ডার গার্টেন, (উভয়)",3487,0,988,1,1,0,1,735,5,9,0,0,1740,32,1772,49.90
78,"কাশিমনগর সরকারি প্রাথমিক বিদ্যালয়, (উভয়)",3285,3,801,2,2,1,1,735,2,4,8,1,1560,79,1639,47.49
16,"উজির আলী সরকারি প্রাথমিক বিদ্যালয়, (উভয়)",2477,6,267,1,1,1,0,739,0,1,0,0,1016,8,1024,41.02
122,"হরিণাকুন্ডু পাইলট মাধ্যমিক বিদ্যালয় ও কলেজ, (উভয়)",2103,0,462,1,0,0,3,739,0,6,0,0,1211,38,1249,57.58
50,"বাদ পুকুরিয়া সরকারি প্রাথমিক বিদ্যালয়, (উভয়)",3849,3,1054,1,1,6,3,740,6,1,1,3,1819,51,1870,47.26
134,"ভায়না সরকারি প্রাথমিক বিদ্যালয়, টিন সেড ভবন, (উভয়)",2366,0,335,0,5,0,8,740,2,1,4,0,1095,0,1095,46.28
162,"শাখারীদহ মাধ্যমিক বিদ্যালয়, (উভয়)",2957,2,977,1,2,0,1,740,1,2,1,1,1728,0,1728,58.44
175,"শ্রীফলতলা সরকারি প্রাথমিক বিদ্যালয়, (উভয়)",2504,0,652,1,2,1,2,740,3,1,1,1,1404,42,1446,56.07
105,"হাট গোপালপুর মাধ্যমিক বিদ্যালয়, (উভয়)",2330,0,605,0,5,1,2,747,4,5,1,0,1370,39,1409,58.80
22,"কাঞ্চননগর মডেল স্কুল এন্ড কলেজ, (উভয়)",2755,1,277,0,0,0,3,751,1,4,2,1,1040,10,1050,37.75
84,"কোরাপাড়া সরকারি প্রাথমিক বিদ্যালয়, (উভয়)",2602,1,550,0,1,0,2,753,3,7,1,0,1318,32,1350,50.65
106,"ছয়াইল সরকারি প্রাথমিক বিদ্যালয়, (উভয়)",1861,1,428,0,0,0,0,763,2,0,0,0,1194,19,1213,64.16
169,"মান্দিয়া মাধ্যমিক বিদ্যালয়, (উভয়)",2620,2,596,0,4,0,6,763,4,8,5,1,1389,62,1451,53.02
58,"শালিয়া সরকারি প্রাথমিক বিদ্যালয়, (উভয়)",2296,4,310,0,0,0,2,766,5,0,2,2,1091,35,1126,47.52
6,"খাজুরা সরকারি প্রাথমিক বিদ্যালয়, (উভয়)",2152,0,376,1,2,1,1,769,0,3,1,0,1154,10,1164,53.62
142,"গাজীপুর সরকারি প্রাথমিক বিদ্যালয়, (উভয়)",2449,4,663,2,0,0,15,770,2,3,7,2,1468,49,1517,59.94
83,"বেড়বাড়ী মাধ্যমিক বিদ্যালয়, (উভয়)",2264,3,710,2,5,0,0,773,2,2,0,0,1497,21,1518,66.12
18,"সরকারি কেশব চন্দ্র কলেজ, (উভয়)",2409,0,206,0,0,0,0,777,3,4,0,0,990,11,1001,41.10
5,"খাজুরা সরকারি প্রাথমিক বিদ্যালয়, (উভয়)",2227,1,284,1,0,0,0,782,3,1,3,0,1075,21,1096,48.27
85,"পাগলাকানাই ইউনিয়ন পরিষদ কমপ্লেক্স, (উভয়)",2696,0,383,0,3,0,1,783,2,4,2,0,1178,19,1197,43.69
66,"জাড়গ্রাম রাউতাইল সরকারি প্রাথমিক বিদ্যালয়, (উভয়)",2502,3,737,3,0,1,0,789,1,7,4,1,1546,62,1608,61.79
55,"সাগান্না সরকারি প্রাথমিক বিদ্যালয়, (উভয়)",3839,1,940,4,1,1,4,792,6,1,4,1,1755,63,1818,45.72
159,"ভালকী সরকারি প্রাথমিক বিদ্যালয়, (উভয়)",2532,1,409,0,0,1,4,792,3,7,4,0,1221,50,1271,48.22
81,"বাড়ীবাথান সরকারি প্রাথমিক বিদ্যালয়, (উভয়)",2254,0,403,1,0,1,1,794,3,6,3,1,1213,28,1241,53.82
89,"বারইখালী সরকারি প্রাথমিক বিদ্যালয়, (উভয়)",1979,1,550,1,3,0,0,794,4,5,4,2,1364,20,1384,68.92
4,"আনোয়ার জাহিদ মাধ্যমিক বিদ্যালয়, (উভয়)",1732,2,311,1,0,0,1,798,1,0,2,0,1116,20,1136,64.43
104,"হাট গোপালপুর সরকারি প্রাথমিক বিদ্যালয়, (উভয়)",2384,1,623,5,3,1,1,802,0,4,1,1,1442,38,1480,60.49
154,"রিশখালী সরকারি প্রাথমিক বিদ্যালয়, (উভয়)",3104,3,625,2,1,2,6,802,2,5,4,2,1454,61,1515,46.84
120,"বানিয়াবহু সরকারি প্রাথমিক বিদ্যালয়, (উভয়)",2053,0,397,1,2,0,0,808,2,1,2,1,1214,23,1237,59.13
73,"চন্ডিপুর বিষ্ণুপদ স্কুল এন্ড কলেজ, (উভয়)",3459,7,799,0,3,0,1,809,5,6,4,0,1634,66,1700,47.24
71,"কালুহাটী দাখিল মাদ্রাসা, (উভয়)",2468,5,668,0,3,0,0,814,2,5,5,1,1503,42,1545,60.90
9,"মুক্তিযোদ্ধা মসিউর রহমান মাধ্যমিক বালিকা বিদ্যালয়, (উভয়)",2973,1,447,0,2,2,1,835,1,1,1,2,1293,29,1322,43.49
15,"ঝিনাইদহ ওয়াজির আলী স্কুল এন্ড কলেজ, (উভয়)",3137,7,279,3,1,0,0,837,3,3,1,0,1134,30,1164,36.15
31,"পবহাটী সরকারি প্রাথমিক বিদ্যালয়, (উভয়)",2482,0,441,1,1,2,1,837,1,2,1,0,1287,10,1297,51.85
117,"লাউদিয়া সরকারি প্রাথমিক বিদ্যালয়, (উভয়)",2153,2,496,4,3,0,0,841,4,3,2,0,1355,22,1377,62.94
96,"সীতারামপুর সরকারি প্রাথমিক বিদ্যালয়, (উভয়)",1799,2,497,2,0,1,1,847,0,2,1,0,1353,25,1378,75.21
152,"রামচন্দ্রপুর সরকারি প্রাথমিক বিদ্যালয়, (উভয়)",2435,1,653,3,0,1,7,849,5,5,5,1,1530,32,1562,62.83
32,"পবহাটী সরকারি প্রাথমিক বিদ্যালয়, (উভয়)",2495,1,356,1,0,0,2,850,0,4,2,0,1216,12,1228,48.74
132,"রহিমপুর সরকারি প্রাথমিক বিদ্যালয়, (উভয়)",2419,2,295,9,5,1,49,850,7,8,30,2,1258,79,1337,52.00
167,"ফলসী সরকারি প্রাথমিক বিদ্যালয়, (উভয়)",2862,3,561,0,2,0,11,853,2,6,0,0,1438,33,1471,50.24
24,"সরকারি নুরুন্নাহার মহিলা কলেজ, (উভয়)",2880,1,657,0,0,1,0,868,1,0,4,1,1533,9,1542,53.23
47,"বেড়াশুলা সরকারি প্রাথমিক বিদ্যালয়, (উভয়)",2261,0,351,0,0,1,1,868,6,1,4,0,1232,61,1293,54.49
57,"হলিধানী সরকারি প্রাথমিক বিদ্যালয়, (উভয়)",3266,2,522,1,1,0,1,870,3,10,0,1,1411,57,1468,43.20
53,"উত্তর নারায়নপুর মাধ্যমিক বিদ্যালয়, (উভয়)",3807,1,731,0,0,0,2,880,4,1,2,15,1636,51,1687,42.97
99,"পাইকপাড়া সরকারি প্রাথমিক বিদ্যালয়, (উভয়)",2607,1,617,2,1,0,1,888,5,7,2,0,1524,54,1578,58.46
173,"পোড়াহাটি সরকারি প্রাথমিক বিদ্যালয়, (উভয়)",3743,1,1391,1,2,1,3,891,6,9,1,0,2306,53,2359,61.61
12,"মুরারীদহ সরকারি প্রাথমিক বিদ্যালয়, (উভয়)",2277,1,349,2,3,0,0,894,5,7,1,0,1262,30,1292,55.42
111,"মোসলেম উদ্দিন মাধ্যমিক বিদ্যালয়, (উভয়)",3295,0,1273,0,2,0,0,894,2,8,0,0,2179,22,2201,66.13
34,"ভুটিয়ারগাতী (রসুলপুর) আলিম মাদ্রাসা, (উভয়)",3278,3,1109,3,0,0,0,905,5,0,4,1,2030,0,2030,61.93
116,"বাগডাঙ্গা সরকারি প্রাথমিক বিদ্যালয়, (উভয়)",1795,0,327,0,1,1,1,907,0,4,0,0,1241,16,1257,69.14
80,"চরখাজুরা সরকারি প্রাথমিক বিদ্যালয়, (উভয়)",2273,1,488,2,2,2,1,909,7,4,2,2,1420,37,1457,62.47
88,"চাপড়ী সরকারি প্রাথমিক বিদ্যালয়, (উভয়)",2452,0,671,2,4,0,0,924,3,5,6,1,1616,21,1637,65.91
125,"হরিণাকুন্ডু সরকারি বালিকা মাধ্যমিক বিদ্যালয়, (উভয়)",3256,0,774,2,1,0,2,930,4,7,3,1,1724,46,1770,52.95
69,"রামনগর কুমড়াবাড়ীয়া সরকারি প্রাথমিক বিদ্যালয়, (উভয়)",2725,1,640,1,3,3,0,947,7,3,5,0,1610,51,1661,59.08
109,"পুটিয়া মাধ্যমিক বিদ্যালয়, (উভয়)",3393,2,1023,3,0,1,0,968,4,5,2,2,2010,51,2061,59.24
70,"চন্ডিপুর সরকারি প্রাথমিক বিদ্যালয়, (উভয়)",3841,4,915,2,1,0,3,977,5,8,7,0,1922,53,1975,50.04
119,"সুরাট সরকারি প্রাথমিক বিদ্যালয়, (উভয়)",2596,1,767,1,0,1,1,977,1,3,1,0,1753,23,1776,67.53
182,"পারমথুরাপুর মাধ্যমিক বিদ্যালয়, (উভয়)",2593,2,635,5,1,1,0,984,2,4,5,0,1639,46,1685,63.21
176,"গাড়াবাড়ীয়া সিদ্দিকীয়া দাখিল মাদ্রাসা, (উভয়)",2851,1,787,3,3,0,3,991,2,9,4,1,1804,24,1828,63.28
161,"কাপাশহাটিয়া সরকারি প্রাথমিক বিদ্যালয়, (উভয়)",2634,1,638,2,1,0,1,992,6,3,1,0,1645,30,1675,62.45
92,"মধুপুর মাধ্যমিক বিদ্যালয়, (উভয়)",2427,2,533,3,7,7,1,997,2,2,2,0,1556,38,1594,64.11
91,"মধুপুর মাধ্যমিক বিদ্যালয়, (উভয়)",2446,1,594,2,1,0,2,1001,2,2,3,0,1608,50,1658,65.74
102,"মাওলানাবাদ মাধ্যমিক বিদ্যালয়, (উভয়)",3013,1,675,4,0,0,3,1017,4,4,4,1,1713,46,1759,56.85
137,"জোড়াদাহ সরকারি প্রাথমিক বিদ্যালয়, (উভয়)",2951,2,567,0,1,0,26,1023,0,5,7,0,1631,45,1676,55.27
158,"ঘোড়াগাছা সরকারি প্রাথমিক ও মাধ্যমিক বিদ্যালয়, (উভয়)",3618,5,733,3,1,1,3,1026,5,2,8,0,1787,54,1841,49.39
41,"বোড়াই সরকারি প্রাথমিক বিদ্যালয়, (উভয়)",4053,4,969,1,1,1,2,1038,4,6,4,0,2030,104,2134,50.09
40,"রাঙ্গিয়ারপোতা সরকারি প্রাথমিক বিদ্যালয়, (উভয়)",3106,0,619,2,2,2,3,1040,0,4,3,1,1676,25,1701,53.96
138,"লালন একাডেমী মাধ্যমিক বিদ্যালয়, (উভয়)",3077,2,773,2,5,0,2,1043,2,2,5,0,1836,41,1877,59.67
129,"তৈলটুপি সরকারি প্রাথমিক বিদ্যালয়, (উভয়)",4072,1,1701,5,2,0,1,1060,12,4,3,1,2790,22,2812,68.52
181,"চাঁদপুর মাধ্যমিক বিদ্যালয়, (উভয়)",3039,1,1040,5,0,2,0,1060,2,2,3,0,2115,37,2152,69.60
94,"পানামী সরকারি প্রাথমিক বিদ্যালয়, (উভয়)",3659,2,1119,4,1,1,2,1062,3,7,4,1,2206,75,2281,60.29
174,"তোলা সরকারি প্রাথমিক বিদ্যালয়, (উভয়)",3048,0,563,0,2,0,4,1103,1,5,4,0,1682,41,1723,55.18
145,"নারায়নকান্দি সরকারি প্রাথমিক বিদ্যালয়, (উভয়)",3494,1,889,4,2,0,12,1121,6,5,9,2,2051,51,2102,58.70
3,"গোপীনাথপুর সরকারি প্রাথমিক বিদ্যালয়, (উভয়)",3299,1,641,1,0,2,1,1124,2,4,1,2,1779,31,1810,53.93
1,"শহীদ স্মৃতি বিদ্যাপীঠ, (উভয়)",3910,1,927,0,0,0,0,1137,5,4,2,0,2076,20,2096,53.09
113,"কালীচরণপুর সরকারি প্রাথমিক বিদ্যালয়, (উভয়)",3454,3,899,4,3,1,1,1143,6,3,8,1,2072,65,2137,59.99
112,"কে, এইচ সরকারি প্রাথমিক বিদ্যালয়, (উভয়)",3285,0,960,3,3,0,3,1152,1,5,3,0,2130,69,2199,64.84
97,"হরিশংকরপুর সরকারি প্রাথমিক বিদ্যালয়, (উভয়)",3433,0,1050,0,2,0,2,1255,2,5,3,4,2323,112,2435,67.67
86,"হীরাডাঙ্গা সরকারি প্রাথমিক বিদ্যালয়, (উভয়)",3241,2,989,5,3,0,0,1283,3,6,4,0,2295,34,2329,70.81
139,"হরিশপুর সরকারি প্রাথমিক বিদ্যালয়, (উভয়)",3469,5,885,0,6,0,9,1324,5,3,6,1,2244,41,2285,64.69
93,"উত্তর দুর্গাপুর সরকারি প্রাথমিক বিদ্যালয়, (উভয়)",3730,3,981,2,1,1,2,1365,7,9,6,1,2378,47,2425,63.75
130,"বাকচুয়া সরকারি প্রাথমিক বিদ্যালয়, (উভয়)",4104,2,883,5,2,3,5,1382,10,4,17,2,2315,92,2407,56.41
114,"বড় কামারকুন্ডু সরকারি প্রাথমিক বিদ্যালয়, (উভয়)",3107,2,319,1,2,1,2,1392,1,1,6,1,1728,44,1772,55.62
90,"পোড়াহাটি সরকারি প্রাথমিক বিদ্যালয়, (উভয়)",3886,1,1030,2,2,1,5,1471,1,6,0,1,2520,74,2594,64.85